##### ########## ######## # #
#                     # # # #
# # ## ### ############ # # #
# #    #   ##           # # #
# # ## ### ############ # # #
  ###              #### # # #
A   ###### ####### ## # # # #
###             ##    # # # #
###### ######## ####### # # #
###### ####                B#
       ######################